****....*****......*********
****.**.*.....****......****
**...**...*******..***.*****
**.*******....*.******.....*
**...*...*.**.*....*******.*
****.*.*...**.*.**.*****.*.*
****.*..*****S*T**.*.....***
*..*.**.**********...***.***
*.**....**.*****.******..***
*..***.**....***.......*...*
**.***.**.**.***.***.**..*.*
**........**.....***.*****.*
********************.......*